9 9 0 2 5 5
1 1 1 2 3 4 5 3 1
1 1 2 3 4 5 3 1 2
1 1 2 1 3 4 5 3 1
1 1 2 3 4 1 5 3 1
5 1 1 2 3 4 5 3 1
1 1 2 3 4 0 3 1 2
1 1 2 1 3 4 5 3 1
1 1 2 1 3 4 5 3 1
1 1 2 3 4 1 5 3 1
3 3 0 1 2 2
2 1 1
1 1 2
1 1 1
4 4 0 1 2 2
2 1 1 3
2 1 2 2
1 2 1 1
1 1 1 1
1 40 0 0 0 10
18 11 19 21 7 1 23 12 17 1 0 10 4 8 12 1 10 2 6 10 3 7 4 6 1 3 24 25 23 2 0 15 11 19 21 7 1 23 12 17 1 0 10 4 8 12 1 10 2 6 10 3
0
